#D#############
#0##000000000##
#0000#0###0#00#
###0##0###0#0##
#0#0#0000#0#00#
#0#0######0#0##
#0#000000#0#00#
#0##0#0#0#0#0##
#0000#0#000000#
#0###0##0###0##
#0#0#0##000000F
#0#0#0#######0#
#000#000000000#
###000#0#0#0#0#
###############



